A, B, I, C - Und wir können’s trotzdem nicht
A.B.I. - Association of being intelligent
AB In den Puff - Die Noten tanzen an der Stange
ABI 2,021‰ - Meist dichter als Denker
ABI 2021 - Autogramme gibt’s später
ABI 2021 - Die Elite braucht kein Motto
ABI 2021 - Ein Drama in 13 Akten
ABI 2021 - Scheiß auf PISA, ist ja nicht unser Turm
ABI 2021 - Wir waren unschuldig und bekamen 13 Jahre
ABI Baba und die 40 Unterkurse - ...
ABI Curie - Zwischen Genie und Wahnsinn
ABI DABU - Endlich weg!
ABI Darnell - Drama, Baby, Drama!
ABI Floyd - We don’t need no education
ABI Rouge - Endlich raus aus dem Rotstiftmilieu
ABI bitte mit Sahne! - ...
ABI con carne - Scharf im Abgang
ABI ergo sum - Ich habe Abi, also bin ich
ABI heute - Captain Morgan
ABI la vista - Die Zukunft wartet
ABI looking for freedom - ...
ABI there for you - ...
ABI - Wir hätten jemanden fragen sollen, der sich damit auskennt
ABI/DC - Highway to Hell
ABIagra - Und das ABI steht
ABIairlines - Wir hoffen, Sie hatten einen angenehmen Flug!
ABIbaba - Aus jeder Flasche kann was werden
ABIbama - Yes, we can!
ABIbel - Hier gelten unsere Gebote
ABIbolika - Der Stoff kam aus dem Lehrerzimmer
ABIbook - Dir und XXX anderen gefällt das
ABIcalypse now - ...
ABIcatraz - Lang genug gesessen
ABIcrombie & Fitch - Die Models gehen, die Elche bleiben
ABIdas - Die Markenware verlässt das Geschäft
ABIdisiakum - Wissen macht unwiderstehlich
ABIdur - Nie wieder Moll
ABIene Maja - Wo ein Willi ist, ist auch ein Weg
ABIertur - Trinkt aus, wir gehen
ABIgasmus - Aber das war nur das Vorspiel
ABIgasmus - 13 Jahre bis zum Höhepunkt
ABIgeddon - Das war knapp
ABIgent - Ausgelernt und Ziel erfasst
ABIgeschrieben - ...
ABIkaribik - Der Fluch hat ein Ende
ABIkea - Lernst du noch oder lebst du schon?
ABIkini - Knapp, aber passt schon!
ABIkur - Endlich relaxen
ABIlanz - Vom Soll ins Haben
ABIleave I can fly - ...
ABIlirium - Wir schlucken einiges
ABIlymp - Wenn Götter gehen
ABIman’s Friends - Sind sie zu schlau, bist du zu dumm
ABImbledon - Auf Gras sind wir besser
ABImorphose - Vom Hugo zum Boss
ABImtote - 13 Jahre unterm Nullniveau
ABIn die Freiheit - ...
ABInal und Elmex - Doppelt hält besser
ABInal - Alles für’n Arsch
ABInet - Wir haben uns durchgegoogelt
ABIpedia - 13 Jahre Copy & Paste
ABIpfiff - Die Champions verlassen das Stadion
ABIpunktur - Jeder Punkt kostet Nerven
ABIputtel - 13 Jahre geknechtet, jetzt geht’s zum Ball
ABIquarium - Die großen Fische verlassen das Becken
ABIraten - Wir verlassen das sinkende Schiff
ABIrobic - Die Gymnasten gehen
ABIsasam - 13 Jahre nicht entwickelt
ABIsaurus Rex - Das Ende der Kreidezeit
ABIsexuell - Offen für alles
ABIsinth - Wir gehen mit Weh(r)mut
ABIsolierzange - Wir haben nicht gekniffen
ABIstokratie - Der Adel geht, der Pöbel bleibt
ABIsutra - Ab sofort auf Stellungssuche
ABItendo - Level 13 complete
ABItiner - Ausreichend gepunktet
ABItomie - Wir haben alles rausgeholt
ABItricks und Mogelnix - Die spinnen, die Lehrer!
ABItuhr - Die schönste Zeit ist vorbei
ABItur est un perroquet - ...
ABIturientchen - Wir watscheln ins Leben
ABItür - Wir haben den Ausgang gefunden
ABIwatchers - Bei meinen Punkten wäre ich fast verhungert!
ABIwehr - getarnte Intelligenz
ABIwesend - für immer entschuldigt
ABIwood - 13 Jahre im falschen Film
ABIós Amigos - ...
AbiCurie - Zwischen Genie und Wahnsinn
Abikalypse - und nach uns die Sintflut
AlABIn - Die Genies sind frei
BABIcue - Wir sind heiß und brauchen Kohle
BABIlon - Und das war erst der Anfang
BArBIe - Yes, we Ken!
BacABI Feeling - ...
BrausetABIlette - Wir zischen ab
CABIsino - 13 Jahre Glück gehabt
CannABIs - Higher educated
CannABIs - Wir haben’s durchgezogen
Circus ABIgalli - Raus aus dem Wahnsinn
CoronABI - Wir haben's überstanden!
C’est l’ABI, chérie! - ...
Don’t worry, ABI happy! - ...
DuschkABIne - Wir brausen ab
El ABIturo - Schule kam uns schon immer Spanisch vor
EnergiespABIlampe - Die wahren Leuchten verschwinden
FerrABI - Leben auf der Überholspur
GABI - Es war eng aber geil!
GABIdalf - Flieht, ihr Narren!
Get ABI or die tryin‘ - ...
GruselkABInett - 13 Jahre Horrorshow
Grün geärgert, blau gemacht, weise geworden - Jetzt wird’s uns zu bunt!
HABI Potter - Wir verlassen die Kammer des Schreckens
HABI Potter - 13 Jahre durchgemuggelt
HABIwaii - Reif für die Insel
Hakuna MatABI - Die Könige von morgen
How I met my ABI - It was legen... (wait for it) ...dary
I can’t be what I wannABI - ...
IlluminABI - Endlich erleuchtet
KABInett - Die Chefetage geht
KABItalismus - 13 Jahre Klassenkampf
KGB - Kampf gegen die Blödheit - Wir haben gesiegt
KafkABI - Der Prozess hat ein Ende
KarABIner - Nichts kann uns halten
KennABI - Ick bin ein Abiturient!
KleptomABIe - Wir stehlen uns davon
KohlrABI - Wir machen uns vom Acker
KollABIeren - nach 13 Jahren am Ende
LABIrinth - Planlos zum Ziel
LABIrinth - Endlich am Ziel
MABIfiosi - 13 Jahre abgezockt
MDMAbi - Alles geschmissen außer die Schule!
MafiABI - 13 Jahre unorganisiertes Verbrechen
Mahatma ABI - Mahatma’s nicht!
MilkABI - Die zarteste Versuchung, seit es Abiturienten gibt
Muhammad ABI - Sieg nach Punkten
My heart skips ABI - ...
NSABI - Wir wissen alles
NinjABI - Unsere Augen waren überall
NutellABI - Alles wie geschmiert
OsamABInladen - 13 Jahre Terror
PABI Schlumpf - 13 Jahre blau
PandABI - Die letzten ihrer Art
PirABI - alle Mann von Board!
RABInson Crusoe - Gerettet nach 13 Jahren
RentABIlität - Und es hat sich doch gelohnt
SalABI - Ist doch alles Wurscht
SemipermeABIlität - Nur die Besten kommen durch
ShishABI - Die Köpfe qualmen
Spieglein, Spieglein an der Wand - wer hat das ABI in der Hand?
Spongebob SchwABIkopf - Die Burger Brater von morgen
Suit up! It’s gonnABI legendary! - ...
SwABIrowski - Die Diamanten sind geschliffen
TeletABI - Wir sagen winke, winke
TherABIe beendet - Wir verlassen die Anstalt
TirABIsu - Auch die Crème de la Crème muss mal gehen
Tour d’ABI - Die härtesten 13 Etappen unseres Lebens
Veni, vidi, abi - ...
Vitamin C, E und ABI - Wir sind gestärkt
VokABI - Voll im Lernstress
Wake me up when ABI ends - ...
WasABI - Der schärfste Jahrgang aller Zeiten
Westminster ABI - Der Adel geht
WhatsABI - zuletzt online 20:21
WubbalABIdubdub - ...
ZABIlando - Schrei vor Glück!
ZABIlando - Schrei vor Glück
ZebrABI - Wir streifen durch das Land
