ABI 2,021‰ - Meist dichter als Denker
ABIdemie - Wenigstens ein Test war positiv
ABIflix - 13 Jahre im falschen Film
ABIgasmus - Wir hätten öfter kommen sollen
ABIhase - 8 Jahre hops genommen
ABIkini - Knapp aber hat gepasst
ABInal - Es war eng aber geil
ABIpedia - 8 Jahre geklaut, kopiert & eingefügt
ABIsexuell - Offen für alles
ABIstoteles - Wir wissen, dass wir nichts wissen
ABItamin - Der Stoff kam aus dem Lehrerzimmer
Abimotto? - Keine Ahnung, war nicht klausurrelevant
CannABIs - 8 Jahre durchgezogen
CannABIs - Mit einer Tüte fing alles an
CoronABI - Wir waren länger dicht als die Schule
Fifteen Shades of Grades - 13 Jahre Folter bis zum Höhepunkt
GiletteABI - 8 Jahre durch rasiert
InstABIlität - Wenn die Elite geht
KohlrABI - Wir machen uns vom Acker
KokABIn - Die Lehrer meinten, wir brauchen den Stoff
KokABIn - Wir haben die Nase voll
lABIrinth - 13 Jahre den Ausgang gesucht
SemipermeABIlität - Nur die besten kommen durch
SnABIchat - Nach 10sek alles vergessen
Suit up! It's gonnABI legendary! - { How I Met Your Mother }
TeletABI - Winke, winke
Westminster ABI - Der Adel geht
Wir haben kein Motto - Ihr habt kein Abi
WubbalABIdubdub - { Rick and Morty }
kABItalismus - 13 Jahre Klassenkampf
kABItän blaubär - Immer blau und trotzdem schlau
